{
  "map": [[1,1,1,1,1,1,1,1],
          [1,0,0,0,0,0,0,1],
          [1,0,1,0,0,1,0,1],
          [1,0,0,0,0,0,0,1],
          [1,0,1,0,0,1,0,1],
          [1,0,0,1,1,0,0,1],
          [1,0,0,0,0,0,0,1],
          [1,1,1,1,1,1,1,1]],
  "size": 8,
  "start_pos": [255, 255, 0],
  "entities": [],
  "enemies": []
}